"/ebc_data/awwohns/selection/getting_target_freqs/targetfreqs_chrs/1_target_freqs.mafs.gz"	"/ebc_data/awwohns/selection/getting_1000g_refs/withrsids/joined/chr1joined.frq"
"/ebc_data/awwohns/selection/getting_target_freqs/targetfreqs_chrs/2_target_freqs.mafs.gz"	"/ebc_data/awwohns/selection/getting_1000g_refs/withrsids/joined/chr2joined.frq"
"/ebc_data/awwohns/selection/getting_target_freqs/targetfreqs_chrs/3_target_freqs.mafs.gz"	"/ebc_data/awwohns/selection/getting_1000g_refs/withrsids/joined/chr3joined.frq"
"/ebc_data/awwohns/selection/getting_target_freqs/targetfreqs_chrs/4_target_freqs.mafs.gz"	"/ebc_data/awwohns/selection/getting_1000g_refs/withrsids/joined/chr4joined.frq"
"/ebc_data/awwohns/selection/getting_target_freqs/targetfreqs_chrs/5_target_freqs.mafs.gz"	"/ebc_data/awwohns/selection/getting_1000g_refs/withrsids/joined/chr5joined.frq"
"/ebc_data/awwohns/selection/getting_target_freqs/targetfreqs_chrs/6_target_freqs.mafs.gz"	"/ebc_data/awwohns/selection/getting_1000g_refs/withrsids/joined/chr6joined.frq"
"/ebc_data/awwohns/selection/getting_target_freqs/targetfreqs_chrs/7_target_freqs.mafs.gz"	"/ebc_data/awwohns/selection/getting_1000g_refs/withrsids/joined/chr7joined.frq"
"/ebc_data/awwohns/selection/getting_target_freqs/targetfreqs_chrs/8_target_freqs.mafs.gz"	"/ebc_data/awwohns/selection/getting_1000g_refs/withrsids/joined/chr8joined.frq"
"/ebc_data/awwohns/selection/getting_target_freqs/targetfreqs_chrs/9_target_freqs.mafs.gz"	"/ebc_data/awwohns/selection/getting_1000g_refs/withrsids/joined/chr9joined.frq"
"/ebc_data/awwohns/selection/getting_target_freqs/targetfreqs_chrs/10_target_freqs.mafs.gz"	"/ebc_data/awwohns/selection/getting_1000g_refs/withrsids/joined/chr10joined.frq"
"/ebc_data/awwohns/selection/getting_target_freqs/targetfreqs_chrs/11_target_freqs.mafs.gz"	"/ebc_data/awwohns/selection/getting_1000g_refs/withrsids/joined/chr11joined.frq"
"/ebc_data/awwohns/selection/getting_target_freqs/targetfreqs_chrs/12_target_freqs.mafs.gz"	"/ebc_data/awwohns/selection/getting_1000g_refs/withrsids/joined/chr12joined.frq"
"/ebc_data/awwohns/selection/getting_target_freqs/targetfreqs_chrs/13_target_freqs.mafs.gz"	"/ebc_data/awwohns/selection/getting_1000g_refs/withrsids/joined/chr13joined.frq"
"/ebc_data/awwohns/selection/getting_target_freqs/targetfreqs_chrs/14_target_freqs.mafs.gz"	"/ebc_data/awwohns/selection/getting_1000g_refs/withrsids/joined/chr14joined.frq"
"/ebc_data/awwohns/selection/getting_target_freqs/targetfreqs_chrs/15_target_freqs.mafs.gz"	"/ebc_data/awwohns/selection/getting_1000g_refs/withrsids/joined/chr15joined.frq"
"/ebc_data/awwohns/selection/getting_target_freqs/targetfreqs_chrs/16_target_freqs.mafs.gz"	"/ebc_data/awwohns/selection/getting_1000g_refs/withrsids/joined/chr16joined.frq"
"/ebc_data/awwohns/selection/getting_target_freqs/targetfreqs_chrs/17_target_freqs.mafs.gz"	"/ebc_data/awwohns/selection/getting_1000g_refs/withrsids/joined/chr17joined.frq"
"/ebc_data/awwohns/selection/getting_target_freqs/targetfreqs_chrs/18_target_freqs.mafs.gz"	"/ebc_data/awwohns/selection/getting_1000g_refs/withrsids/joined/chr18joined.frq"
"/ebc_data/awwohns/selection/getting_target_freqs/targetfreqs_chrs/19_target_freqs.mafs.gz"	"/ebc_data/awwohns/selection/getting_1000g_refs/withrsids/joined/chr19joined.frq"
"/ebc_data/awwohns/selection/getting_target_freqs/targetfreqs_chrs/20_target_freqs.mafs.gz"	"/ebc_data/awwohns/selection/getting_1000g_refs/withrsids/joined/chr20joined.frq"
"/ebc_data/awwohns/selection/getting_target_freqs/targetfreqs_chrs/21_target_freqs.mafs.gz"	"/ebc_data/awwohns/selection/getting_1000g_refs/withrsids/joined/chr21joined.frq"
"/ebc_data/awwohns/selection/getting_target_freqs/targetfreqs_chrs/22_target_freqs.mafs.gz"	"/ebc_data/awwohns/selection/getting_1000g_refs/withrsids/joined/chr22joined.frq"
